###DENKI-MAP###
level 01

15 20

1 1 1 1 1 1 1 1 1 1 1 1 1 1 1 1 1 1 1 1
1 1 0 0 0 1 0 0 0 0 0 0 0 0 0 0 0 0 0 1
1 0 0 0 1 1 0 0 0 0 0 0 0 0 0 0 0 0 0 1
1 0 0 1 0 1 0 0 0 0 0 0 0 0 0 0 0 0 0 1
1 0 0 0 0 1 0 0 0 0 0 0 0 0 1 0 0 0 0 1
1 0 0 0 0 1 0 0 0 0 1 0 0 0 0 0 0 0 0 1
1 0 0 0 1 1 1 0 0 0 1 0 0 0 0 0 0 0 0 1
1 0 0 0 0 0 0 0 0 0 2 0 0 0 0 0 0 0 0 1
1 0 0 0 0 0 0 0 0 0 2 0 0 0 0 0 0 0 0 1
1 0 0 0 0 0 2 0 0 0 0 0 0 0 0 0 0 0 0 1
1 0 0 0 0 0 2 2 2 2 2 0 0 0 0 0 0 0 0 1
1 0 0 0 0 0 0 2 0 0 0 0 0 0 0 0 0 0 0 1
1 0 0 0 0 0 0 0 0 0 0 0 0 0 0 0 0 0 0 1
1 0 0 0 0 0 0 0 0 0 0 0 0 0 0 0 0 0 0 1
1 1 1 1 1 1 1 1 1 1 1 1 1 1 1 1 1 1 1 1

5 2

00220
02222
